ee A1 ee ee ee ee ee ee ee
ee C1 ee ee ee ee ee ee A2
ee G2 ee ee G1 ee ee ee ee
ee P1 ee ee ee ee ee ee ee
ee ee ee ee ee ee ee ee ee
ee ee ee G1 ee ee ee ee ee
ee ee ee ee ee ee G1 ee ee
ee G1 ee ee ee ee ee ee ee
ee ee ee ee G1 ee ee ee ee
ee G1 ee ee ee ee E1 ee ee
A4 ee ee ee ee ee ee ee ee
ee ee ee ee ee ee ee A3 ee