G2 ee ee G1 ee ee
P1 ee ee ee ee ee
ee ee ee ee ee ee
ee ee G1 ee ee ee
ee ee ee ee ee G1
G1 ee ee ee ee ee
ee ee ee G1 ee ee
G1 ee ee ee ee E1