G1 G1 G1 G1 G1 G1 G1 G1 G1 G1 G1 G1 G1 G1 G1 G1 G1 G1 G1 G1 G1 G1 G1 G1 G1 G1 G1 G1 G1 G1
G1 ee ee ee ee ee ee ee ee ee ee ee ee ee ee ee ee ee ee ee ee ee ee ee ee ee T2 ee ee G1
G1 ee ee ee ee ee ee ee ee ee ee ee ee ee G2 G2 G2 ee ee ee ee ee ee ee ee ee ee ee V1 G1
G1 ee ee ee ee ee ee ee ee ee ee ee ee ee ee ee ee ee G2 G2 G2 ee ee ee ee G2 G2 G2 G2 G1
G1 ee ee ee ee A1 ee ee C1 ee ee A1 ee ee C1 A1 C1 ee A1 ee ee ee ee ee ee ee ee ee ee G1
G1 ee ee ee ee ee G2 G2 G2 G2 G2 ee G2 G2 G2 G2 G2 G2 ee ee ee ee ee ee ee ee ee ee ee G1
G1 ee ee ee ee ee ee ee ee ee ee ee ee ee ee ee ee ee ee ee ee ee ee ee ee ee ee ee ee G1
G1 ee ee ee ee ee G2 ee ee ee ee ee ee ee ee ee ee ee ee ee ee ee ee ee ee ee ee ee ee G1
G1 P1 ee ee T3 ee ee ee G2 ee G2 G2 ee ee ee ee ee ee ee ee ee ee ee ee ee ee ee ee T1 G1
G1 G1 G1 G1 G1 G1 G1 G1 G1 G3 G1 G1 G1 G1 G1 G1 G1 G1 G1 G1 G1 G1 G3 G3 G1 G1 G3 G3 G1 G1
ee ee ee ee ee ee ee ee G1 G1 G1 ee ee ee ee ee ee ee ee ee ee G1 G1 G1 G1 G1 G1 G1