G1 G1 G1 G1 G1 G1 G1 G1 G1 G1 G1 G1 G1 G1
G1 ee ee ee ee ee ee ee ee ee ee ee ee G1
G1 ee ee ee ee ee ee ee ee ee ee V1 ee G1
G1 ee ee ee ee ee ee ee ee ee ee G2 G2 G1
G1 ee ee ee ee ee ee C1 ee ee ee ee ee G1
G1 ee ee ee ee G2 G2 G2 G2 G2 ee ee ee G1
G1 ee ee ee ee ee ee ee ee ee ee ee ee G1
G1 ee G2 G2 G2 G2 ee ee ee ee ee ee ee G1
G1 P1 ee ee ee ee ee ee ee G2 ee G2 ee G1
G1 G1 G1 G1 G1 G1 G1 G1 G1 G3 G1 G1 G1 G1